15 7
1 30
0
0 0 0 0 0 0 0
0 0 1 0 1 0 0
0 0 1 0 1 0 0
0 0 1 0 1 0 0
0 0 1 0 1 0 0
0 0 1 0 1 0 0
0 0 1 4 1 0 0
0 0 1 2 1 0 0
0 0 1 3 1 0 0
0 0 1 0 1 0 0
0 0 1 0 1 0 0
0 0 1 0 1 0 0
0 0 1 0 1 0 0
0 0 1 0 1 0 0
0 0 0 0 0 0 0
XXX